20
cat
M######
#######
#C#####
M####C#
#######
#######
#####P#
