20
cat
#######
#######
#######
#######
#M###C#
#######
#WW##P#