20
mouse
#######
#CWM###
##W####
##P####
###W###
#######
#######