20
cat
###P###
WWWWWWW
#WW#WW#
#WW#WW#
#######
#######
C##M###