20
mouse
######C
M######
###W###
###W###
###W###
#######
###P###