20
cat
M######
#######
#C#####
#######
##WW###
##W####
###P###