20
cat
M#####C
#######
###W###
###W###
###W###
#######
###P###