20
mouse
#######
#######
#######
#######
#M###C#
#######
#WW##P#