20
cat
#######
#####P#
#######
#WWW###
###W#M#
#######
####C##