20
cat
#######
#######
#C##M##
#######
##WW###
##W####
###P###